"player_name","MP","G","GS","FG","x3P","x2P","FT","PTS"
"Aaron Gordon",2633,78,78,470,121,349,185,1246
"Aaron Holiday",646,50,50,105,43,62,41,294
"Abdel Nader",694,61,61,91,32,59,27,241
"Al-Farouq Aminu",2292,81,81,257,96,161,150,760
"Al Horford",1973,68,68,387,73,314,78,925
"Alan Williams",26,5,5,8,0,8,2,18
"Alec Burks",2750,128,128,384,122,262,232,1122
"Alex Abrines",588,31,31,56,41,15,12,165
"Alex Caruso",531,25,25,77,24,53,51,229
"Alex Len",1544,77,77,320,74,246,140,854
"Alex Poythress",305,21,21,40,9,31,18,107
"Alfonzo McKinnie",1003,72,72,134,42,92,27,337
"Alize Johnson",64,14,14,4,1,3,4,13
"Allen Crabbe",1133,43,43,137,98,39,41,413
"Allonzo Trier",1459,64,64,232,52,180,179,695
"Amile Jefferson",68,12,12,10,0,10,7,27
"Amir Johnson",529,51,51,79,12,67,31,201
"Andre Drummond",2647,79,79,561,5,556,243,1370
"Andre Iguodala",1578,68,68,151,48,103,39,389
"Andre Ingram",15,4,4,0,0,0,0,0
"Andrew Bogut",134,11,11,18,0,18,3,39
"Andrew Harrison",374,34,34,32,10,22,34,108
"Andrew Wiggins",2543,73,73,498,118,380,207,1321
"Anfernee Simons",141,20,20,28,10,18,9,75
"Ángel Delgado",15,2,2,1,0,1,1,3
"Ante Žižic",1082,59,59,183,0,183,93,459
"Anthony Davis",1850,56,56,530,48,482,344,1452
"Anthony Tolliver",1079,65,65,99,81,18,47,326
"Antonio Blakeney",829,57,57,166,36,130,50,418
"Aron Baynes",821,51,51,105,21,84,53,284
"Austin Rivers",4056,152,152,464,208,256,100,1236
"Avery Bradley",3810,126,126,496,172,324,86,1250
"B.J. Johnson",98,14,14,18,6,12,4,46
"Bam Adebayo",1913,82,82,280,3,277,166,729
"Ben McLemore",158,19,19,25,17,8,8,75
"Ben Simmons",2700,79,79,540,0,540,257,1337
"Billy Garrett",63,4,4,11,0,11,4,26
"Bismack Biyombo",783,54,54,89,0,89,58,236
"Blake Griffin",2622,75,75,619,189,430,414,1841
"Boban Marjanovic",1362,116,116,320,8,312,196,844
"Bobby Portis",2598,100,100,558,150,408,154,1420
"Bogdan Bogdanovic",1947,70,70,361,134,227,134,990
"Bojan Bogdanovic",2573,81,81,522,164,358,246,1454
"Bonzie Colson",98,8,8,13,5,8,8,39
"Brad Wanamaker",343,36,36,50,16,34,24,140
"Bradley Beal",3028,82,82,764,209,555,362,2099
"Brandon Goodwin",57,16,16,6,2,4,9,23
"Brandon Ingram",1760,52,52,362,31,331,195,950
"Brandon Knight",1472,78,78,198,82,116,54,532
"Brandon Sampson",214,14,14,28,11,17,4,71
"Brook Lopez",2322,81,81,355,187,168,112,1009
"Bruce Brown",1449,74,74,125,24,101,45,319
"Bruno Caboclo",800,34,34,96,48,48,42,282
"Bryn Forbes",2293,82,82,361,176,185,69,967
"Buddy Hield",2615,82,82,623,278,345,171,1695
"C.J. Miles",1712,106,106,224,134,90,96,678
"C.J. Williams",128,15,15,17,5,12,0,39
"Caleb Swanigan",356,42,42,36,2,34,12,86
"Cameron Payne",1424,80,80,192,50,142,66,500
"Cameron Reynolds",259,19,19,33,21,12,8,95
"Caris LeVert",1063,40,40,207,48,159,85,547
"Carmelo Anthony",294,10,10,49,21,28,15,134
"Cedi Osman",2444,76,76,360,130,230,141,991
"Chandler Hutchison",895,44,44,96,14,82,23,229
"Chandler Parsons",496,25,25,68,29,39,22,187
"Channing Frye",341,36,36,43,32,11,11,129
"Chasson Randle",743,49,49,91,46,45,43,271
"Cheick Diallo",896,64,64,168,1,167,50,387
"Chimezie Metu",145,29,29,19,0,19,13,51
"Chris Boucher",163,28,28,34,12,22,13,93
"Chris Chiozza",33,7,7,2,2,0,0,6
"Chris Paul",1857,58,58,302,127,175,175,906
"Christian Wood",502,42,42,122,18,104,82,344
"CJ McCollum",2375,70,70,571,167,404,159,1468
"Clint Capela",2249,67,67,474,0,474,166,1114
"Cody Zeller",1243,49,49,190,6,184,111,497
"Collin Sexton",2605,82,82,519,119,400,214,1371
"Corey Brewer",984,62,62,106,28,78,62,302
"Cory Joseph",2063,82,82,226,55,171,30,537
"Courtney Lee",856,68,68,106,32,74,28,272
"Cristiano Felício",746,60,60,95,0,95,50,240
"D'Angelo Russell",2448,81,81,659,234,425,160,1712
"D.J. Augustin",2269,81,81,318,131,187,181,948
"D.J. Stephens",7,1,1,1,0,1,0,2
"D.J. Wilson",882,48,48,104,46,58,26,280
"Dairis Bertans",167,12,12,12,10,2,0,34
"Damian Jones",410,24,24,53,0,53,24,130
"Damian Lillard",2838,80,80,681,237,444,468,2067
"Damion Lee",375,32,32,56,27,29,19,158
"Damyean Dotson",2004,73,73,290,126,164,73,779
"Daniel Hamilton",204,19,19,23,8,15,3,57
"Daniel Theis",908,66,66,146,26,120,56,374
"Danilo Gallinari",2059,68,68,409,161,248,367,1346
"Danny Green",2216,80,80,293,198,95,37,821
"Dante Cunningham",928,64,64,75,30,45,14,194
"Dante Exum",664,42,42,101,18,83,68,288
"Danuel House",979,39,39,118,74,44,56,366
"Dario Šaric",4046,162,162,608,236,372,264,1716
"Darius Miller",1757,69,69,189,133,56,56,567
"Darren Collison",2143,76,76,308,79,229,158,853
"Daryl Macon",90,8,8,10,5,5,4,29
"David Nwaba",984,51,51,126,24,102,58,334
"Davis Bertans",1632,76,76,204,145,59,53,606
"Davon Reed",47,10,10,5,2,3,0,12
"De'Aaron Fox",2546,81,81,505,86,419,303,1399
"De'Anthony Melton",984,50,50,100,29,71,21,250
"DeAndre' Bembry",1931,82,82,275,50,225,87,687
"Deandre Ayton",2183,71,71,509,0,509,141,1159
"DeAndre Jordan",4094,138,138,572,0,572,372,1516
"Delon Wright",3398,150,150,484,100,384,238,1306
"DeMar DeRozan",2688,77,77,631,7,624,366,1635
"DeMarcus Cousins",771,30,30,178,26,152,106,488
"DeMarre Carroll",1703,67,67,227,106,121,184,744
"Demetrius Jackson",39,6,6,8,2,6,4,22
"Deng Adel",194,19,19,11,6,5,4,32
"Dennis Schröder",2314,79,79,457,124,333,186,1224
"Dennis Smith",3016,106,106,556,134,422,198,1444
"Deonte Burton",240,32,32,33,8,25,8,82
"Derrick Favors",1766,76,76,363,17,346,154,897
"Derrick Jones",1153,60,60,160,28,132,74,422
"Derrick Rose",1392,51,51,363,54,309,137,917
"Derrick White",1728,67,67,260,48,212,95,663
"DeVaughn Akoon-Purcell",22,7,7,3,0,3,1,7
"Devin Booker",2242,64,64,586,135,451,393,1700
"Devin Harris",1071,68,68,132,62,70,102,428
"Devin Robinson",95,7,7,19,0,19,9,47
"Devonte' Graham",676,46,46,74,34,40,35,217
"Dewayne Dedmon",1609,64,64,259,83,176,92,693
"Deyonta Davis",118,9,9,15,0,15,6,36
"Dillon Brooks",330,18,18,49,15,34,22,135
"Dion Waiters",1138,44,44,198,109,89,22,527
"Dirk Nowitzki",795,51,51,135,64,71,39,373
"Domantas Sabonis",1838,74,74,413,9,404,208,1043
"Donatas Motiejunas",13,3,3,3,0,3,0,6
"Donovan Mitchell",2598,77,77,661,188,473,319,1829
"Donte DiVincenzo",411,27,27,50,22,28,9,131
"Donte Grantham",2,3,3,0,0,0,0,0
"Dorian Finney-Smith",1985,81,81,228,79,149,73,608
"Doug McDermott",1340,77,77,207,84,123,66,564
"Dragan Bender",826,46,46,88,22,66,32,230
"Draymond Green",2065,66,66,188,47,141,63,486
"Drew Eubanks",113,23,23,15,0,15,11,41
"Duncan Robinson",161,15,15,18,10,8,4,50
"Dusty Hannahs",26,2,2,3,0,3,2,8
"Dwayne Bacon",759,43,43,122,38,84,34,316
"Dwight Howard",230,9,9,43,0,43,29,115
"Dwight Powell",1662,77,77,290,39,251,196,815
"Dwyane Wade",1885,72,72,416,86,330,165,1083
"Džanan Musa",39,9,9,9,1,8,0,19
"E'Twaun Moore",1463,53,53,256,76,180,45,633
"Ed Davis",1446,81,81,186,0,186,100,472
"Edmond Sumner",210,23,23,22,7,15,15,66
"Ekpe Udoh",320,51,51,50,0,50,19,119
"Elfrid Payton",1250,42,42,179,33,146,55,446
"Elie Okobo",958,53,53,114,39,75,37,304
"Emanuel Terry",46,6,6,8,0,8,4,20
"Emmanuel Mudiay",1607,59,59,330,69,261,144,873
"Enes Kanter",3280,134,134,750,20,730,310,1830
"Eric Bledsoe",2272,78,78,470,124,346,177,1241
"Eric Gordon",2158,68,68,384,216,168,119,1103
"Eric Moreland",86,10,10,6,2,4,0,14
"Ersan Ilyasova",1231,67,67,167,58,109,61,453
"Evan Fournier",2553,81,81,468,153,315,137,1226
"Evan Turner",1605,73,73,204,11,193,75,494
"Frank Jackson",1169,61,61,194,53,141,54,495
"Frank Kaminsky",755,47,47,138,50,88,79,405
"Frank Mason",435,38,38,71,14,57,39,195
"Frank Ntilikina",904,43,43,95,33,62,23,246
"Fred VanVleet",1760,64,64,246,112,134,97,701
"Furkan Korkmaz",679,48,48,98,47,51,36,279
"Garrett Temple",4080,150,150,416,180,236,160,1172
"Gary Clark",641,51,51,50,41,9,7,148
"Gary Harris",1639,57,57,270,82,188,115,737
"Gary Payton",16,3,3,5,1,4,0,11
"Gary Trent",111,15,15,16,5,11,3,40
"George Hill",2604,120,120,340,96,244,140,916
"George King",6,1,1,0,0,0,0,0
"Georges Niang",516,59,59,86,43,43,20,235
"Gerald Green",1473,73,73,231,156,75,57,675
"Giannis Antetokounmpo",2358,72,72,721,52,669,500,1994
"Glenn Robinson",610,47,47,74,18,56,32,198
"Goran Dragic",991,36,36,179,57,122,79,494
"Gordon Hayward",1863,72,72,296,77,219,156,825
"Gorgui Dieng",1031,76,76,189,19,170,88,485
"Grayson Allen",416,38,38,67,32,35,45,211
"Greg Monroe",960,86,86,184,2,182,90,460
"Guerschon Yabusele",251,41,41,35,9,26,15,94
"Hamidou Diallo",526,51,51,75,4,71,36,190
"Harrison Barnes",5066,154,154,862,348,514,458,2530
"Harry Giles",820,58,58,175,0,175,58,408
"Hassan Whiteside",1674,72,72,388,2,386,109,887
"Haywood Highsmith",40,5,5,4,1,3,0,9
"Henry Ellenson",518,38,38,78,34,44,38,228
"Ian Clark",973,60,60,151,66,85,33,401
"Ian Mahinmi",498,34,34,47,3,44,42,139
"Ike Anigbogu",6,3,3,0,0,0,0,0
"Iman Shumpert",2962,124,124,334,190,144,72,930
"Isaac Bonga",120,22,22,5,0,5,9,19
"Isaac Humphries",56,5,5,6,3,3,0,15
"Isaiah Briscoe",559,39,39,55,11,44,15,136
"Isaiah Canaan",1258,60,60,128,68,60,38,362
"Isaiah Hartenstein",221,28,28,20,2,18,11,53
"Isaiah Hicks",32,3,3,4,0,4,4,12
"Isaiah Thomas",181,12,12,34,12,22,17,97
"Ish Smith",1251,56,56,205,44,161,47,501
"Ivan Rabb",721,49,49,116,3,113,49,284
"Ivica Zubac",2080,118,118,424,0,424,202,1050
"J.J. Barea",752,38,38,161,38,123,55,415
"J.J. Redick",2379,76,76,452,240,212,228,1372
"J.P. Macura",17,2,2,3,0,3,0,6
"J.R. Smith",222,11,11,27,12,15,8,74
"Jabari Parker",3448,128,128,738,122,616,262,1860
"Jacob Evans",204,30,30,18,4,14,0,40
"Jae Crowder",2166,80,80,318,173,145,142,951
"Jahlil Okafor",935,59,59,212,1,211,59,484
"JaKarr Sampson",127,4,4,29,5,24,17,80
"Jake Layman",1327,71,71,216,59,157,50,541
"Jakob Pöltl",1273,77,77,187,0,187,49,423
"Jalen Brunson",1591,73,73,264,63,201,87,678
"Jalen Jones",214,16,16,26,10,16,19,81
"Jamal Crawford",1211,64,64,174,67,107,93,508
"Jamal Murray",2447,75,75,513,152,361,189,1367
"James Ennis",2460,116,116,276,110,166,116,778
"James Harden",2867,78,78,843,378,465,754,2818
"James Johnson",1164,55,55,164,50,114,50,428
"James Nunnally",204,30,30,24,16,8,8,72
"JaMychal Green",2742,130,130,460,142,318,160,1222
"Jared Dudley",1220,59,59,101,53,48,32,287
"Jared Terrell",111,14,14,12,4,8,3,31
"Jarell Martin",328,42,42,43,20,23,9,115
"Jaren Jackson",1515,58,58,298,51,247,151,798
"Jaron Blossomgame",439,27,27,47,10,37,10,114
"Jarred Vanderbilt",69,17,17,9,0,9,6,24
"Jarrett Allen",2096,80,80,335,6,329,197,873
"Jason Smith",380,40,40,42,18,24,28,130
"JaVale McGee",1671,75,75,400,1,399,96,897
"Jawun Evans",130,16,16,6,0,6,0,12
"Jaylen Adams",428,34,34,38,25,13,7,108
"Jaylen Brown",1913,74,74,368,95,273,133,964
"Jaylen Morris",29,4,4,4,1,3,1,10
"Jayson Tatum",2455,79,79,466,116,350,195,1243
"Jeff Green",2097,77,77,326,111,215,183,946
"Jeff Teague",1264,42,42,176,35,141,123,510
"Jemerrio Jones",143,6,6,12,2,10,1,27
"Jerami Grant",2612,80,80,409,115,294,157,1090
"Jeremy Lamb",2250,79,79,431,115,316,231,1208
"Jeremy Lin",2872,148,148,476,110,366,352,1414
"Jerian Grant",939,60,60,92,40,52,26,250
"Jerome Robinson",320,33,33,44,18,26,6,112
"Jerryd Bayless",657,34,34,82,29,53,16,209
"Jevon Carter",577,39,39,56,34,22,26,172
"Jimmer Fredette",65,6,6,8,0,8,6,22
"Jimmy Butler",4370,130,130,836,134,702,624,2430
"Joakim Noah",693,42,42,110,0,110,78,298
"Jodie Meeks",104,8,8,21,8,13,1,51
"Joe Chealey",8,1,1,1,0,1,0,2
"Joe Harris",2293,76,76,374,183,191,110,1041
"Joe Ingles",2568,82,82,359,189,170,87,994
"Joel Embiid",2154,64,64,580,79,501,522,1761
"John Collins",1829,61,61,465,55,410,203,1188
"John Henson",188,14,14,31,11,20,6,79
"John Holland",1,1,1,0,0,0,0,0
"John Jenkins",666,52,52,84,44,40,30,242
"John Wall",1104,32,32,245,51,194,122,663
"Johnathan Motley",156,22,22,39,0,39,24,102
"Johnathan Williams",372,24,24,65,0,65,27,157
"Jon Leuer",402,41,41,66,1,65,23,156
"Jonah Bolden",639,44,44,80,34,46,13,207
"Jonas Jerebko",1218,73,73,163,69,94,64,459
"Jonas Valanciunas",2182,98,98,602,28,574,294,1526
"Jonathan Isaac",1996,75,75,262,86,176,110,720
"Jonathon Simmons",2128,112,112,266,56,210,144,732
"Jordan Bell",788,68,68,99,0,99,25,223
"Jordan Clarkson",2214,81,81,529,144,385,162,1364
"Jordan Loyd",55,12,12,8,4,4,9,29
"Jordan McRae",333,27,27,61,10,51,28,160
"Jordan Sibert",4,1,1,1,1,0,0,3
"José Calderón",632,49,49,45,14,31,9,113
"Josh Hart",1715,67,67,189,92,97,55,525
"Josh Jackson",1988,79,79,347,73,274,143,910
"Josh Okogie",1757,74,74,196,60,136,118,570
"Josh Richardson",2539,73,73,423,164,259,199,1209
"Jrue Holiday",2402,67,67,547,118,429,208,1420
"Juan Hernangómez",1358,70,70,138,66,72,66,408
"Julian Washburn",254,18,18,16,5,11,3,40
"Julius Randle",2232,73,73,571,67,504,356,1565
"Justin Anderson",463,48,48,64,24,40,26,178
"Justin Holiday",5214,164,164,600,324,276,190,1714
"Justin Jackson",3228,162,162,434,174,260,124,1166
"Justin Patton",21,3,3,2,0,2,1,5
"Justise Winslow",1959,66,66,324,96,228,86,830
"Jusuf Nurkic",1974,72,72,420,3,417,282,1125
"Kadeem Allen",416,19,19,65,17,48,42,189
"Kalin Lucas",6,1,1,0,0,0,2,2
"Karl-Anthony Towns",2545,77,77,681,142,539,376,1880
"Kawhi Leonard",2040,60,60,560,112,448,364,1596
"Keita Bates-Diop",503,30,30,60,13,47,18,151
"Kelly Olynyk",1812,79,79,261,113,148,152,787
"Kelly Oubre",3870,138,138,750,216,534,378,2094
"Kemba Walker",2863,82,82,731,260,471,380,2102
"Kenneth Faried",1456,74,74,312,16,296,128,768
"Kenrich Williams",1079,46,46,107,52,55,13,279
"Kent Bazemore",1643,67,67,278,96,182,127,779
"Kentavious Caldwell-Pope",2035,82,82,325,151,174,137,938
"Kevin Durant",2702,78,78,721,137,584,448,2027
"Kevin Huerter",2048,75,75,275,136,139,41,727
"Kevin Knox",2158,75,75,338,125,213,162,963
"Kevin Love",598,22,22,109,53,56,103,374
"Kevon Looney",1481,80,80,217,1,216,65,500
"Khem Birch",643,50,50,91,0,91,58,240
"Khris Middleton",2393,77,77,506,179,327,216,1407
"Khyri Thomas",195,26,26,22,10,12,7,61
"Klay Thompson",2652,78,78,655,241,414,129,1680
"Kobi Simmons",2,1,1,0,0,0,0,0
"Kosta Koufos",502,42,42,73,0,73,10,156
"Kostas Antetokounmpo",11,2,2,0,0,0,2,2
"Kris Dunn",1389,46,46,215,34,181,55,519
"Kyle Anderson",1281,43,43,150,9,141,37,346
"Kyle Korver",2668,140,140,402,276,126,120,1200
"Kyle Kuzma",2314,70,70,496,128,368,188,1308
"Kyle Lowry",2213,65,65,304,157,147,161,926
"Kyle O'Quinn",371,45,45,69,1,68,17,156
"Kyrie Irving",2214,67,67,604,174,430,214,1596
"LaMarcus Aldridge",2687,81,81,684,10,674,349,1727
"Lance Stephenson",1123,68,68,184,73,111,50,491
"Lance Thomas",783,46,46,78,22,56,27,205
"Landry Shamet",3604,158,158,480,334,146,150,1444
"Langston Galloway",1745,80,80,228,135,93,81,672
"Larry Nance",1795,67,67,249,33,216,96,627
"Lauri Markkanen",1682,52,52,342,120,222,170,974
"LeBron James",1937,55,55,558,111,447,278,1505
"Lonnie Walker",118,17,17,16,5,11,8,45
"Lonzo Ball",1423,47,47,185,75,110,20,465
"Lorenzo Brown",212,26,26,23,6,17,3,55
"Lou Williams",1993,75,75,484,105,379,425,1498
"Luc Mbah a Moute",61,4,4,8,2,6,2,20
"Luka Doncic",2318,72,72,506,168,338,346,1526
"Luke Kennard",1437,63,63,228,106,122,51,613
"Luke Kornet",784,46,46,107,70,37,38,322
"Luol Deng",392,22,22,59,14,45,25,157
"Malachi Richardson",103,22,22,9,8,1,4,30
"Malcolm Brogdon",1832,64,64,378,104,274,141,1001
"Malcolm Miller",67,10,10,11,10,1,3,35
"Malik Beasley",1879,81,81,349,163,186,56,917
"Malik Monk",1258,73,73,227,109,118,90,653
"Marc Gasol",4872,158,158,780,198,582,384,2142
"Marcin Gortat",751,47,47,99,0,99,35,233
"Marco Belinelli",1815,79,79,285,147,138,112,829
"Marcus Derrickson",67,11,11,16,10,6,4,46
"Marcus Morris",2091,75,75,377,146,231,146,1046
"Marcus Smart",2200,80,80,239,126,113,104,708
"Mario Hezonja",1206,58,58,191,42,149,87,511
"Markelle Fultz",427,19,19,65,4,61,21,155
"Markieff Morris",2540,116,116,408,136,272,142,1094
"Marquese Chriss",998,86,86,134,32,102,64,364
"MarShon Brooks",387,29,29,76,15,61,23,190
"Marvin Bagley",1567,62,62,356,30,326,181,923
"Marvin Williams",2133,75,75,275,140,135,66,756
"Mason Plumlee",1731,82,82,262,2,260,111,637
"Matthew Dellavedova",1624,96,96,196,88,108,84,564
"Maurice Harkless",1415,60,60,189,33,156,49,460
"Maxi Kleber",1502,71,71,175,77,98,58,485
"Melvin Frazier",44,10,10,7,0,7,1,15
"Meyers Leonard",878,61,61,132,50,82,43,357
"Michael Beasley",277,26,26,75,3,72,28,181
"Michael Carter-Williams",744,56,56,92,20,72,64,268
"Michael Kidd-Gilchrist",1179,64,64,158,16,142,95,427
"Mikal Bridges",2417,82,82,242,105,137,95,684
"Mike Conley",2342,70,70,490,155,335,343,1478
"Mike Muscala",2612,128,128,290,178,112,140,898
"Mike Scott",2790,158,158,336,202,134,44,918
"Miles Bridges",1696,80,80,237,65,172,58,597
"Miles Plumlee",173,18,18,32,0,32,16,80
"Miloš Teodosic",150,15,15,17,10,7,4,48
"Mitch Creek",96,10,10,16,0,16,10,42
"Mitchell Robinson",1360,66,66,202,0,202,81,485
"Mo Bamba",766,47,47,117,21,96,37,292
"Monte Morris",1970,82,82,346,94,252,65,851
"Montrezl Harrell",2158,82,82,546,3,543,266,1361
"Moritz Wagner",446,43,43,71,22,49,43,207
"Myles Turner",2119,74,74,380,76,304,148,984
"Naz Mitrou-Long",84,14,14,6,2,4,2,16
"Nemanja Bjelica",1788,77,77,284,103,181,70,741
"Nenê Hilário",546,42,42,60,0,60,31,151
"Nerlens Noel",1055,77,77,162,0,162,54,378
"Nick Young",37,4,4,3,3,0,0,9
"Nicolas Batum",2354,75,75,253,116,137,77,699
"Nik Stauskas",2030,136,136,272,140,132,114,798
"Nikola Jokic",2504,80,80,616,83,533,289,1604
"Nikola Mirotic",2490,92,92,476,232,244,210,1394
"Nikola Vucevic",2510,80,80,701,84,617,179,1665
"Noah Vonleh",1722,68,68,207,46,161,111,571
"Norman Powell",1126,60,60,193,68,125,62,516
"OG Anunoby",1352,67,67,183,67,116,36,469
"Okaro White",6,3,3,0,0,0,0,0
"Omari Spellman",805,46,46,98,44,54,32,272
"Omri Casspi",520,36,36,86,15,71,39,226
"Otto Porter",3366,112,112,598,208,390,156,1560
"P.J. Tucker",2802,82,82,207,146,61,41,601
"Pascal Siakam",2548,80,80,519,79,440,237,1354
"Pat Connaughton",1261,61,61,163,66,97,29,421
"Patrick Beverley",2137,78,78,194,112,82,96,596
"Patrick McCaw",794,58,58,52,18,34,26,148
"Patrick Patterson",861,63,63,82,46,36,19,229
"Patty Mills",1908,82,82,282,159,123,88,811
"Pau Gasol",720,60,60,84,12,72,56,236
"Paul George",2841,77,77,707,292,415,453,2159
"Paul Millsap",1895,70,70,322,58,264,181,883
"PJ Dozier",51,6,6,8,2,6,1,19
"Quincy Acy",123,10,10,4,2,2,7,17
"Quincy Pondexter",292,53,53,29,6,23,34,98
"Quinn Cook",1059,74,74,204,81,123,20,509
"R.J. Hunter",26,1,1,6,4,2,1,17
"Rajon Rondo",1369,46,46,175,51,124,23,424
"Raul Neto",474,37,37,74,20,54,28,196
"Rawle Alkins",120,10,10,13,3,10,8,37
"Ray Spalding",296,28,28,50,0,50,8,108
"Raymond Felton",379,33,33,55,20,35,12,142
"Reggie Bullock",3758,126,126,490,296,194,146,1422
"Reggie Jackson",2289,82,82,441,174,267,204,1260
"Richaun Holmes",1184,70,70,222,0,222,128,572
"Ricky Rubio",1899,68,68,295,79,216,195,864
"Robert Covington",2406,70,70,312,170,142,136,930
"Robert Williams",283,32,32,36,0,36,9,81
"Robin Lopez",1606,74,74,304,7,297,89,704
"Rodions Kurucs",1294,63,63,202,58,144,72,534
"Rodney Hood",3786,144,144,584,168,416,274,1610
"Rodney McGruder",1550,66,66,186,79,107,52,503
"Ron Baker",304,30,30,8,2,6,10,28
"Rondae Hollis-Jefferson",1234,59,59,200,9,191,118,527
"Royce O'Neale",1671,82,82,163,68,95,32,426
"Rudy Gay",1842,69,69,376,74,302,120,946
"Rudy Gobert",2577,81,81,476,0,476,332,1284
"Russell Westbrook",2630,73,73,630,119,511,296,1675
"Ryan Anderson",644,50,50,42,18,24,24,126
"Ryan Arcidiacono",1961,81,81,187,81,106,89,544
"Ryan Broekhoff",453,42,42,57,38,19,15,167
"Salah Mejri",399,36,36,55,11,44,20,141
"Sam Dekker",1576,94,94,240,38,202,56,574
"Scott Machado",19,4,4,4,1,3,1,10
"Semi Ojeleye",594,56,56,67,28,39,24,186
"Serge Ibaka",2010,74,74,464,49,415,135,1112
"Seth Curry",1399,74,74,212,113,99,44,581
"Shabazz Napier",983,56,56,169,76,93,115,529
"Shai Gilgeous-Alexander",2174,82,82,341,51,290,156,889
"Shake Milton",268,20,20,34,14,20,5,87
"Shaquille Harrison",1430,73,73,184,24,160,82,474
"Shaun Livingston",967,64,64,109,0,109,40,258
"Shelvin Mack",2492,114,114,326,92,234,116,860
"Sindarius Thornwell",313,64,64,17,3,14,25,62
"Skal Labissière",352,44,44,52,12,40,18,134
"Solomon Hill",878,44,44,68,32,36,23,191
"Spencer Dinwiddie",1914,68,68,366,124,242,287,1143
"Stanley Johnson",2416,132,132,342,124,218,100,908
"Stephen Curry",2331,69,69,632,354,278,263,1881
"Sterling Brown",1034,58,58,145,53,92,29,372
"Steven Adams",2669,80,80,481,0,481,146,1108
"Sviatoslav Mykhailiuk",880,84,84,92,58,34,24,266
"T.J. Leaf",522,58,58,99,8,91,19,225
"T.J. McConnell",1470,76,76,220,14,206,29,483
"T.J. Warren",1360,43,43,297,77,220,101,772
"Tahjere McCall",8,1,1,2,0,2,0,4
"Taj Gibson",1686,70,70,304,11,293,134,753
"Taurean Waller-Prince",1552,55,55,262,123,139,95,742
"Terrance Ferguson",1931,74,74,185,106,79,37,513
"Terrence Jones",5,2,2,1,0,1,0,2
"Terrence Ross",2150,81,81,440,217,223,126,1223
"Terry Rozier",1791,79,79,258,119,139,73,708
"Thabo Sefolosha",609,50,50,71,34,37,14,190
"Thaddeus Young",2489,81,81,443,51,392,87,1024
"Theo Pinson",211,18,18,25,12,13,19,81
"Thomas Bryant",1496,72,72,309,33,276,107,758
"Thomas Welsh",36,11,11,7,3,4,1,18
"Thon Maker",1944,128,128,218,98,120,112,646
"Tim Frazier",2240,118,118,232,74,158,82,620
"Tim Hardaway",4114,130,130,780,324,456,464,2348
"Timothé Luwawu-Cabarrot",1338,100,100,164,72,92,62,462
"Tobias Harris",5694,164,164,1222,312,910,532,3288
"Tomáš Satoranský",2164,80,80,257,64,193,131,709
"Tony Bradley",36,3,3,8,0,8,1,17
"Tony Parker",1003,56,56,213,13,200,91,530
"Tony Snell",1304,74,74,163,81,82,37,444
"Torrey Craig",1503,75,75,160,61,99,49,430
"Trae Young",2503,81,81,525,156,369,343,1549
"Treveon Graham",715,35,35,64,38,26,18,184
"Trevon Duval",6,3,3,2,1,1,0,5
"Trevor Ariza",4698,138,138,588,290,298,260,1726
"Trey Burke",2250,116,116,472,112,360,206,1262
"Trey Lyles",1120,64,64,207,51,156,81,546
"Tristan Thompson",1198,43,43,201,0,201,68,470
"Troy Brown",730,52,52,97,22,75,32,248
"Troy Caupain",16,4,4,4,2,2,0,10
"Troy Daniels",760,51,51,113,74,39,18,318
"Troy Williams",312,21,21,44,14,30,9,111
"Tyler Cavanaugh",39,11,11,3,1,2,2,9
"Tyler Davis",1,1,1,0,0,0,0,0
"Tyler Dorsey",1396,96,96,214,88,126,76,592
"Tyler Johnson",3058,114,114,434,180,254,190,1238
"Tyler Lydon",94,25,25,9,4,5,1,23
"Tyler Ulis",1,1,1,0,0,0,0,0
"Tyler Zeller",186,12,12,32,0,32,28,92
"Tyreke Evans",1402,69,69,257,77,180,115,706
"Tyrone Wallace",628,62,62,92,4,88,30,218
"Tyson Chandler",1750,110,110,122,0,122,102,346
"Tyus Jones",1560,68,68,185,40,145,58,468
"Udonis Haslem",74,10,10,11,0,11,3,25
"Victor Oladipo",1147,36,36,249,74,175,103,675
"Vince Carter",1330,76,76,196,123,73,47,562
"Vince Edwards",16,2,2,1,1,0,0,3
"Wade Baldwin",94,16,16,10,2,8,8,30
"Walt Lemon",167,6,6,38,2,36,8,86
"Wayne Ellington",2594,106,106,368,276,92,78,1090
"Wayne Selden",2878,150,150,392,110,282,134,1028
"Wendell Carter",1110,44,44,180,6,174,89,455
"Wesley Iwundu",1233,68,68,113,29,84,84,339
"Wesley Johnson",1068,76,76,90,50,40,26,256
"Wesley Matthews",4182,138,138,558,300,258,264,1680
"Will Barton",1189,43,43,185,67,118,57,494
"Willie Cauley-Stein",2213,81,81,412,1,411,140,965
"Willy Hernangómez",812,58,58,153,15,138,100,421
"Wilson Chandler",2354,102,102,228,118,110,36,610
"Yante Maten",13,2,2,1,0,1,0,2
"Yogi Ferrell",1067,71,71,153,54,99,60,420
"Yuta Watanabe",174,15,15,15,2,13,7,39
"Zach Collins",1356,77,77,189,40,149,94,512
"Zach LaVine",2171,63,63,530,120,410,312,1492
"Zach Lofton",4,1,1,0,0,0,0,0
"Zaza Pachulia",878,68,68,85,0,85,97,267
"Zhaire Smith",111,6,6,14,6,8,6,40
"Zhou Qi",1,1,1,1,0,1,0,2
